AAAC	GTTT	
AAAG	CTTT	
AAAT	ATTT	
AACA	TGTT	
AACC	GGTT	
AACG	CGTT	
AACT	AGTT	
AAGA	TCTT	
AAGC	GCTT	
AAGG	CCTT	
AAGT	ACTT	
AATA	TATT	
AATC	GATT	
AATG	CATT	
ACAA	TTGT	
ACAG	CTGT	
ACAT	ATGT	
ACCA	TGGT	
ACCC	GGGT	
ACCG	CGGT	
ACCT	AGGT	
ACGA	TCGT	
ACGC	GCGT	
ACGG	CCGT	
ACTA	TAGT	
ACTC	GAGT	
ACTG	CAGT	
AGAA	TTCT	
AGAC	GTCT	
AGAT	ATCT	
AGCA	TGCT	
AGCC	GGCT	
AGCG	CGCT	
AGGA	TCCT	
AGGC	GCCT	
AGGG	CCCT	
AGTA	TACT	
AGTC	GACT	
AGTG	CACT	
ATAA	TTAT	
ATAC	GTAT	
ATAG	CTAT	
ATCA	TGAT	
ATCC	GGAT	
ATGA	TCAT	
ATGG	CCAT	
ATTC	GAAT	
ATTG	CAAT	
CAAA	TTTG	
CAAC	GTTG	
CAAG	CTTG	
CACC	GGTG	
CACG	CGTG	
CAGA	TCTG	
CAGC	GCTG	
CAGG	CCTG	
CATA	TATG	
CATC	GATG	
CCAA	TTGG	
CCAC	GTGG	
CCAG	CTGG	
CCCA	TGGG	
CCCG	CGGG	
CCGA	TCGG	
CCGC	GCGG	
CCTA	TAGG	
CCTC	GAGG	
CGAA	TTCG	
CGAC	GTCG	
CGAG	CTCG	
CGCA	TGCG	
CGCC	GGCG	
CGGA	TCCG	
CGTC	GACG	
CTAA	TTAG	
CTAC	GTAG	
CTCA	TGAG	
CTCC	GGAG	
CTGA	TCAG	
CTGC	GCAG	
CTTA	TAAG	
CTTC	GAAG	
GAAA	TTTC	
GAAC	GTTC	
GACA	TGTC	
GACC	GGTC	
GAGC	GCTC	
GATA	TATC	
GCAA	TTGC	
GCAC	GTGC	
GCCA	TGGC	
GCCC	GGGC	
GCGA	TCGC	
GGAA	TTCC	
GGAC	GTCC	
GGCA	TGCC	
GGGA	TCCC	
GGTA	TACC	
GTAA	TTAC	
GTCA	TGAC	
GTGA	TCAC	
GTTA	TAAC	
TAAA	TTTA	
TACA	TGTA	
TAGA	TCTA	
TCAA	TTGA	
TCCA	TGGA	
TGAA	TTCA	
